##################################################
#                             #                  #
#                                                #
#        #                    #                  #
#                             #                  #
#                         ######                 #
#                              ######            #
#             ###                   #            #
#                              #  ###            #
####### ######                 #    #            #
#           ########           ######            #
#            #                 #                 #
#            # ## ##      ######                 #
#        ##  #                                   #
#            #                                   #
#        #####                                   #
#        #                     #                 #
#     ####                     #                 #
#        #                                       #
##################################################