##########################################################################################################################################################################
#                                 #                                                                      #                                #                              #
#           ######## ##           #                                                                      #                                #                              #
#           #         #           #                                                                      #                                #                              #
#           #         #           #                                                                      #                                #                              #
#           ##        #           #                                                                     ##                               #                               #
#            ##       #           #                                                                     #                               #                                #
#             ##     #            ################   ########################   ################ ########                               #                                #
#              #     #                           #                                                 #                                  ###                                #
#       ########    ##                           #                         #############           #                #                ##### ############################# #
#              ######                            #                                      ############                                                                     #
#                                                #                                                      #                                                                #
#                                              ###                                                      #                                                                #
#                                            ##                                                         #    ###########                                                 #
#                                       ######                                                          ################                                                 #
#                                                                                                $                                                                       #
#                                                                                                                                                  #                     #
#                                                                                  ###                                                             #                     #
#                                                                                    #                     #######  ################################                     #
#                                  ##                                                #                                                             #                     #
#                                ####                             #                  #                                                             #                     #
#                                                             ## # # ##              #                                                             #                     #
#                                                                 #                  #                                                             #                     #
#####################################  ##########                                    ##                             #                              #                     #
#                              #           #    #                    #               #                                                             ##                    #
#                              #           #    #                 ######             ##############       ##                                        ###                  #
#                              #           #    ###                 #    #                       #                                                                       #
#                              ######  #####      #                      ###     #               #                                                                       #
#                                                 #             #                         #######                                               #                        #
#                                                 #           ###     ##                                         ####                         #####                      #
#                                                 #            #       #                                           #                            #                        #
#                                                 #            #       #                                           #                            #                        #
#                                                 #            ##      #                                           ##                          ###                       #
#                                 ##  ##############            #       #                    ######               ##                      #############                  #
#                                 #  ##            #            #       #                         ##             ##                  ########       ########             #
#                                 # ##             #            #       #                          #             ##                #####                 #####           #
#                                 #                #            ##  ######                         #            ##               ####                       ####         #
########################          #                #                                             ######       ##                ##                             ##        #
#                      #          #                #                                             ####        ##                ## #  #  #  #  #  #  #  #  #  #  ##       #
# ######                          #                #                                             ####        ##                #             #   #   #           #       #
#      ####                       #                #                                                #### ########              #               # # #                     #
#          ##          #          #                #                                                ####                       #                 #                       #
##########################################################################################################################################################################